1111111111111111111111111111111111
1000000000000000000000000000000001
1E00010100100000101001000000010101
1000010010101010001001000000010101
1PC000000000000000X000000000000001
1111111111111111111111111111111111
