111111111111
10000000001
111000000011
100P00000001
1000000E0001
111111111111
